#####################
#S#   #   ###   #   #
# # # # #   # # # # #
# # #   ### #   # # #
# ### ###   ##### # #
#   #   # #     #   #
### # # # # ### ### #
#   # #   #   #   # #
# ### ### ### # ### #
#     #   #   #   E #
#####################
