########################
#S   #        #       #
# ## # ###### # ### # #
#    #      # #   #   #
#### #### # #### ### ##
#        #      #     #
# ###### ######## ### #
#      #      #   #   #
### ## ###### ### ### #
#    #      #     E   #
########################
