################
#S   #     #   #
# ## ### # ### #
#      # #     #
#### # # ##### #
#    # #     # #
# #### ### # # #
#        # #   #
### #### # ### #
#      #   #  E#
################
