########################
#S     #      #     #  #
# ### #### ## ### ### ##
#   #      #      #    #
### ######## ####### ####
#     #    #       #    #
# ### # #### ##### #### #
# #   #      #   #      #
# # ####### ### ####### #
# #       #     #     E #
########################
