#####################
#S#   #   #     #   #
# # # # # # ### # # #
# # #   #   #   # # #
# ### ### ##### # # #
#   #   #     #   # #
### # ### ### ### # #
#   #   # #   #   # #
# ### ### # ### ### #
#     #   #   #   E #
#####################



